4 2 3 2 3 2 3 2 3 2 3 2 3 2 3 2 4
4 1 0 1 0 1 0 1 0 1 0 1 0 1 0 1 4
4 0 1 0 1 0 1 0 1 0 1 0 1 0 1 0 4
4 1 0 1 0 1 0 1 0 1 0 1 0 1 0 1 4
4 0 1 0 1 0 1 0 1 0 1 0 1 0 1 0 4
4 1 0 1 0 1 0 1 0 1 0 1 0 1 0 1 4
4 0 1 0 1 0 1 0 1 0 1 0 1 0 1 0 4
4 1 0 1 0 1 0 1 0 1 0 1 0 1 0 1 4
4 0 1 0 1 0 1 0 1 0 1 0 1 0 1 0 4
4 1 0 1 0 1 0 1 0 1 0 1 0 1 0 1 4
4 0 1 0 1 0 1 0 1 0 1 0 1 0 1 0 4
4 1 0 1 0 1 0 1 0 1 0 1 0 1 0 1 4
4 0 1 0 1 0 1 0 1 0 1 0 1 0 1 0 4
4 1 0 1 0 1 0 1 0 1 0 1 0 1 0 1 4
4 2 3 2 3 2 3 2 3 2 3 2 3 2 3 2 4
